Pizza = İtalya kökenli, hamur üstü çeşitli malzemeler.
Sushi = Japonya’dan, pirinç ve çiğ balık.
Taco = Meksika usulü, tortilla içinde malzeme.
Kebap = Türkiye ve çevresinde ızgarada pişen et.
Burger = Amerika’nın meşhur ekmek arası köftesi.
Fries = Patates kızartması, fast food yan ürünü.
Pasta = Tatlı hamur işi, kremalı veya meyveli.
Noodle = Asya kökenli ince makarna çeşidi.
Paella = İspanya’nın deniz ürünlü pilavı.
Curry = Baharatlı soslu Hindistan yemeği.
Falafel = Orta Doğu’nun nohut köftesi.
Waffle = Belçika usulü tatlı hamur.
Baklava = Kat kat hamur ve şerbet tatlısı.
Muffin = Mini kek, meyveli veya çikolatalı.
Churro = Kızarmış tatlı çubuk, şekerli.
Krep = İnce, tatlı veya tuzlu Fransız keki.
Ekler = Kremalı ve çikolatalı tatlı.
Dondurma = Soğuk, tatlı buzlu yiyecek.
Helva = Susam veya irmikten yapılan tatlı.
Pavlova = Mereng tabanlı, meyveli tatlı.
Trileçe = Sütlü, yumuşak Latin Amerika tatlısı.
Pankek = Krep benzeri tatlı hamur.
Tiramisu = Kahveli İtalyan tatlısı.
Döner = Türkiye’de dikey döner ocaklarında pişen et.
Mantı = Küçük hamur parçaları içine kıyma konup haşlanır, yoğurtlu servis edilir.
Lahmacun = İnce hamur üzerine kıymalı harç sürülerek pişirilir.
İskender = Döner dilimleri üzerine domates sos ve yoğurt konur.
Köfte = Baharatlı kıyma topları, ızgara veya kızartma.
Çorba = Genellikle sebze veya et bazlı sıcak sıvı başlangıç.
Börek = İnce yufka arasına peynir, kıyma veya ıspanak konur.
Kısır = İnce bulgur, domates ve yeşilliklerle yapılan soğuk salata.
Sarma = Asma yaprağı veya lahana yaprağına sarılı iç harç.
Muhallebi = Sütle yapılan hafif tatlı.
Güllaç = Ramazanda tercih edilen sütlü tatlı, ince yufkalarla.
Künefe = Tel kadayıf, peynirle yapılan şerbetli tatlı.
Pilav = Pirinç veya bulgurla yapılan garnitür.
Ezogelin = Baharatlı kırmızı mercimek çorbası.
ÇiğKöfte = Baharatlı, etsiz ya da etli yoğrulmuş köfte.
Sütlaç = Fırında pişirilmiş pirinçli süt tatlısı.
Meze = Çeşitli soğuk başlangıçlar, küçük porsiyonlar.
